"filename", "language", "C++", "XML", "comment", "blank", "total"
"/home/jcoli/develop/Platformio/projects/grow_1/include/Free_Fonts.h", "C++", 264, 0, 55, 61, 380
"/home/jcoli/develop/Platformio/projects/grow_1/include/buttons.h", "C++", 6, 0, 6, 5, 17
"/home/jcoli/develop/Platformio/projects/grow_1/include/comm_bt.h", "C++", 5, 0, 6, 4, 15
"/home/jcoli/develop/Platformio/projects/grow_1/include/comm_wifi.h", "C++", 8, 0, 6, 5, 19
"/home/jcoli/develop/Platformio/projects/grow_1/include/defines.h", "C++", 31, 0, 7, 11, 49
"/home/jcoli/develop/Platformio/projects/grow_1/include/disp_footpage.h", "C++", 4, 0, 7, 5, 16
"/home/jcoli/develop/Platformio/projects/grow_1/include/disp_page0.h", "C++", 4, 0, 7, 5, 16
"/home/jcoli/develop/Platformio/projects/grow_1/include/display.h", "C++", 5, 0, 6, 4, 15
"/home/jcoli/develop/Platformio/projects/grow_1/include/display_navigation.h", "C++", 4, 0, 6, 4, 14
"/home/jcoli/develop/Platformio/projects/grow_1/include/eprom.h", "C++", 13, 0, 6, 4, 23
"/home/jcoli/develop/Platformio/projects/grow_1/include/icons/alert-decagram-outline-25.h", "C++", 19, 0, 60, 6, 85
"/home/jcoli/develop/Platformio/projects/grow_1/include/icons/arduino.h", "C++", 19, 0, 60, 6, 85
"/home/jcoli/develop/Platformio/projects/grow_1/include/icons/bell-alert.h", "C++", 18, 0, 61, 6, 85
"/home/jcoli/develop/Platformio/projects/grow_1/include/icons/bx+door+open.h", "C++", 12, 0, 52, 6, 70
"/home/jcoli/develop/Platformio/projects/grow_1/include/icons/bxs+door+open.h", "C++", 19, 0, 60, 6, 85
"/home/jcoli/develop/Platformio/projects/grow_1/include/icons/cat.h", "C++", 19, 0, 60, 6, 85
"/home/jcoli/develop/Platformio/projects/grow_1/include/icons/door+closed.h", "C++", 19, 0, 60, 6, 85
"/home/jcoli/develop/Platformio/projects/grow_1/include/icons/dryer.h", "C++", 19, 0, 60, 6, 85
"/home/jcoli/develop/Platformio/projects/grow_1/include/icons/fan-13.h", "C++", 19, 0, 60, 6, 85
"/home/jcoli/develop/Platformio/projects/grow_1/include/icons/fan-2.h", "C++", 19, 0, 60, 6, 85
"/home/jcoli/develop/Platformio/projects/grow_1/include/icons/fan-alert.svg", "XML", 0, 1, 0, 0, 1
"/home/jcoli/develop/Platformio/projects/grow_1/include/icons/fan-alert.xml", "XML", 0, 5, 0, 1, 6
"/home/jcoli/develop/Platformio/projects/grow_1/include/icons/fan-custom.h", "C++", 14, 0, 50, 6, 70
"/home/jcoli/develop/Platformio/projects/grow_1/include/icons/fan.h", "C++", 1029, 0, 282, 6, 1317
"/home/jcoli/develop/Platformio/projects/grow_1/include/icons/heat-wave.h", "C++", 19, 0, 60, 6, 85
"/home/jcoli/develop/Platformio/projects/grow_1/include/icons/home-assistant.h", "C++", 19, 0, 60, 6, 85
"/home/jcoli/develop/Platformio/projects/grow_1/include/icons/images.h", "C++", 9931, 0, 0, 8, 9939
"/home/jcoli/develop/Platformio/projects/grow_1/include/icons/logo.h", "C++", 28, 0, 41, 6, 75
"/home/jcoli/develop/Platformio/projects/grow_1/include/icons/snowflake.h", "C++", 19, 0, 60, 6, 85
"/home/jcoli/develop/Platformio/projects/grow_1/include/icons/thermometer-alert.h", "C++", 19, 0, 60, 6, 85
"/home/jcoli/develop/Platformio/projects/grow_1/include/icons/thermometer.h", "C++", 19, 0, 60, 6, 85
"/home/jcoli/develop/Platformio/projects/grow_1/include/icons/tumble-dryer.h", "C++", 19, 0, 60, 6, 85
"/home/jcoli/develop/Platformio/projects/grow_1/include/icons/vin3.h", "C++", 50, 0, 53, 6, 109
"/home/jcoli/develop/Platformio/projects/grow_1/include/icons/wi-fi-1.h", "C++", 16, 0, 53, 6, 75
"/home/jcoli/develop/Platformio/projects/grow_1/include/icons/wi-fi.h", "C++", 19, 0, 60, 6, 85
"/home/jcoli/develop/Platformio/projects/grow_1/include/input_analog_control.h", "C++", 3, 0, 6, 4, 13
"/home/jcoli/develop/Platformio/projects/grow_1/include/input_digital_control.h", "C++", 3, 0, 6, 5, 14
"/home/jcoli/develop/Platformio/projects/grow_1/include/io_defines.h", "C++", 29, 0, 33, 14, 76
"/home/jcoli/develop/Platformio/projects/grow_1/include/mqtt_controll.h", "C++", 6, 0, 6, 5, 17
"/home/jcoli/develop/Platformio/projects/grow_1/include/output_digital_control.h", "C++", 4, 0, 6, 4, 14
"/home/jcoli/develop/Platformio/projects/grow_1/include/pitches.h", "C++", 90, 0, 6, 1, 97
"/home/jcoli/develop/Platformio/projects/grow_1/include/program.h", "C++", 3, 0, 6, 5, 14
"/home/jcoli/develop/Platformio/projects/grow_1/include/sounds.h", "C++", 3, 0, 6, 4, 13
"/home/jcoli/develop/Platformio/projects/grow_1/include/structures.h", "C++", 232, 0, 11, 45, 288
"/home/jcoli/develop/Platformio/projects/grow_1/include/tools.h", "C++", 8, 0, 6, 5, 19
"/home/jcoli/develop/Platformio/projects/grow_1/include/variables.h", "C++", 82, 0, 6, 16, 104
"/home/jcoli/develop/Platformio/projects/grow_1/src/buttons.cpp", "C++", -48, 0, -6, -14, -68
"/home/jcoli/develop/Platformio/projects/grow_1/src/comm_bt.cpp", "C++", -34, 0, -7, -15, -56
"/home/jcoli/develop/Platformio/projects/grow_1/src/comm_wifi.cpp", "C++", -78, 0, -18, -25, -121
"/home/jcoli/develop/Platformio/projects/grow_1/src/disp_footpage.cpp", "C++", -84, 0, -28, -19, -131
"/home/jcoli/develop/Platformio/projects/grow_1/src/disp_page0.cpp", "C++", -100, 0, -8, -23, -131
"/home/jcoli/develop/Platformio/projects/grow_1/src/display.cpp", "C++", -33, 0, -6, -21, -60
"/home/jcoli/develop/Platformio/projects/grow_1/src/display_navigation.cpp", "C++", -78, 0, -22, -7, -107
"/home/jcoli/develop/Platformio/projects/grow_1/src/eprom.cpp", "C++", -147, 0, -46, -40, -233
"/home/jcoli/develop/Platformio/projects/grow_1/src/input_analog_control.cpp", "C++", -19, 0, -6, -14, -39
"/home/jcoli/develop/Platformio/projects/grow_1/src/input_digital_control.cpp", "C++", -12, 0, -9, -13, -34
"/home/jcoli/develop/Platformio/projects/grow_1/src/main.cpp", "C++", -165, 0, -32, -43, -240
"/home/jcoli/develop/Platformio/projects/grow_1/src/mqtt_controll.cpp", "C++", -19, 0, -8, -18, -45
"/home/jcoli/develop/Platformio/projects/grow_1/src/output_digital_control.cpp", "C++", -10, 0, -6, -7, -23
"/home/jcoli/develop/Platformio/projects/grow_1/src/program.cpp", "C++", -12, 0, -6, -12, -30
"/home/jcoli/develop/Platformio/projects/grow_1/src/sounds.cpp", "C++", -58, 0, -6, -10, -74
"/home/jcoli/develop/Platformio/projects/grow_1/src/tools.cpp", "C++", -75, 0, -7, -8, -90
"Total", "-", 11218, 6, 1481, 68, 12773